..............G
..............G
GG............G
..............G
...GG.........G
..............G
......GG......G
..............G
..........GG..G
........GG....G
..P...GG.....EG
GGGGGGGGGGGGGGG