...............................................................................................................
...............................................................................................................
.......................................................GGG.....................................................
......................................................GGGGG....................................................
.....................................................GGGGGGG.....G.............................................
....................................................GGGGGGGGG.........G........................................
...................................................GGGGGGGGGGG..............G..............................G...
..................................................GGGGGGGGGGGGG..................G..G..G..G..G..G..G..G..G.....
.................................................GGGGGGGGGGGGGGG...............................................
................................................GGGGGGGGGGGGGGGGG..............................................
..P........GG..GG..GG..GG..GG..................GGGGGGGGGGGGGGGGGGG...........................................E.
GGGGGGGGGG....................GGGGGGGGGGGGGGGGGGGGGGGGGGGGGGGGGGGGGGGGGGGGGGGGGGGGGGGGGGGGGGGGGGGGGGGGGGGGGGGGG